--------
-O-   A-
-      -  
- - X  -
- - ----
- -    -
-      -
-    ---
------  