 ---       
 -O--------
 - --     -
 - -- --- -
 -        -
 - - -- ---
-- - -   - 
-AX      - 
---  -   - 
  -------- 